111111111111111
100000000000001
100000000000001
100000000000001
100001111110001
110000000000001
101000000000001
100011111100001
100000000000001
111111111111111